30 30
3 1 1 1 1 3 1 1 1 1 3 1 1 1 13 3 1 1 1 1 3 1 1 1 1 3 1 1 1 3 
1 1000 2000 0 1002 1 4001 0 1000 1000 1 0 0 0 0 0 0 0 0 1 1000 1000 0 4001 1 1002 0 2000 1000 1 
12 0 0 0 0 13 0 0 0 0 12 0 1000 1000 2000 2000 1000 1000 0 12 0 0 0 0 13 0 0 0 0 12 
1 0 0 -1 0 1 0 0 0 0 1 0 0 0 0 0 0 0 0 1 1002 0 0 0 1 0 0 0 0 1 
1 0 0 0 0 1 0 0 0 0 1 0 0 0 0 0 0 0 0 1 1001 0 0 0 1 0 0 0 0 1 
3 1000 0 0 0 1 0 0 0 0 1 1000 0 0 0 0 0 0 1000 1 0 0 0 0 1 0 0 0 1000 3 
1 1 1 3 900 3 900 3 1 1 1 1 1 3 0 0 3 1 1 1 1 1 3 900 3 900 3 1 1 1 
1 2000 0 0 0 0 0 0 0 0 0 0 0 0 0 0 0 0 0 0 0 0 0 0 0 0 0 0 2000 1 
1 1000 0 0 0 0 0 0 0 0 0 0 0 0 1000 1000 0 0 0 0 0 0 0 0 0 0 0 0 1000 1 
1 1 1 13 1 1 1 1 3 0 0 3 1 1 13 1 1 1 3 0 0 3 1 1 1 1 13 1 1 3 
3 0 2000 1 0 0 0 1000 1 0 0 1 1002 0 4000 4000 0 1002 1 0 0 1 1000 0 0 0 1 2000 1000 1 
1 0 0 3 0 0 0 0 1 0 0 3 0 0 0 0 0 0 3 0 0 1 0 0 0 0 3 0 0 1 
12 0 0 0 0 0 0 1002 13 0 0 900 0 0 0 0 0 0 900 0 0 12 1002 0 0 0 0 0 0 13 
13 0 0 0 0 0 0 1001 12 0 0 3 0 0 0 0 0 0 3 0 0 13 1001 0 0 0 0 0 0 12 
1 0 0 3 0 0 0 0 1 0 0 1 1 3 2000 2000 3 1 1 0 0 1 0 0 0 0 3 0 0 1 
3 0 0 1 4000 0 0 1000 1 0 0 1 1000 1000 1000 1000 1000 1000 1 0 0 1 1000 0 0 4000 1 0 0 3 
1 0 0 3 1 1 1 1 3 0 0 3 1 1 1 1 1 1 3 0 0 3 1 1 1 1 3 0 0 1 
13 0 0 0 0 0 0 0 0 0 0 0 0 0 0 0 0 0 0 0 0 0 0 0 0 0 0 0 0 1 
12 0 0 0 0 0 0 0 0 0 0 0 0 0 0 0 0 0 0 0 0 0 0 0 0 0 0 0 0 13 
1 0 0 3 1 1 1 1 1 1 1 1 1 1 13 12 1 1 1 1 1 1 1 1 1 1 3 0 0 1 
3 0 0 1 4001 0 0 0 0 0 0 0 1000 1000 1000 1000 1000 1000 0 0 0 0 0 0 0 4001 1 0 0 3 
1 0 0 1 4001 0 0 0 0 0 0 0 0 0 2000 2000 0 0 0 0 0 0 0 0 0 4001 1 0 0 1 
1 0 0 1 0 0 0 0 0 0 0 0 0 0 0 0 0 0 0 0 0 0 0 0 0 0 1 0 0 1 
1 0 0 3 1 3 900 3 1 1 1 1 1 1 12 13 1 1 1 1 1 1 3 900 3 1 3 0 0 1 
12 0 0 0 0 0 0 0 0 0 0 0 0 0 0 0 0 0 0 0 0 0 0 0 0 0 0 0 0 1 
3 0 0 0 0 0 0 0 0 0 0 0 0 0 0 0 0 0 0 0 0 0 0 0 0 0 0 0 0 3 
1 0 0 3 900 3 1 1 3 900 3 1 1 3 0 0 3 1 1 1 3 900 3 1 3 900 3 0 0 1 
1 0 0 1 0 0 1 0 0 0 0 1 1000 0 0 0 0 1000 1 0 0 0 0 1 0 0 1 0 0 1 
1 1000 2000 1 0 1000 1 1000 4001 0 1000 1 1000 0 2000 2000 0 1000 1 1000 0 4001 1000 1 1000 0 1 2000 1000 1 
3 1 1 1 1 3 1 1 1 1 3 1 1 1 13 3 1 1 1 1 3 1 1 1 1 3 1 1 1 3 
