30 30
1 1 2 2 1 1 1 2 2 1 1 1 1 1 2 2 1 1 1 1 1 2 2 1 1 1 2 2 1 1 
1 1000 2000 0 0 1 4001 0 1000 1000 1 0 0 0 0 0 0 0 0 1 1000 1000 0 4001 1 0 0 2000 1000 1 
2 0 0 0 0 2 0 0 0 0 2 0 1000 1000 2000 2000 1000 1000 0 2 0 0 0 0 2 0 0 0 0 2 
2 0 0 -1 0 2 0 0 0 0 2 0 3 3 2 2 3 3 0 2 0 0 0 0 2 0 0 0 0 2 
1 0 0 0 0 1 0 0 0 0 1 0 0 0 0 0 0 0 0 1 0 0 0 0 1 0 0 0 0 1 
1 1000 0 0 0 1 0 0 0 0 1 1000 0 0 0 0 0 0 1000 1 0 0 0 0 1 0 0 0 1000 1 
1 1 1 3 0 3 0 3 1 1 1 1 1 3 0 0 3 1 1 1 1 1 3 0 3 0 3 1 1 1 
1 2000 0 0 0 0 0 0 0 0 0 0 0 0 0 0 0 0 0 0 0 0 0 0 0 0 0 0 2000 1 
1 1000 0 0 0 0 0 0 0 0 0 0 0 0 1000 1000 0 0 0 0 0 0 0 0 0 0 0 0 1000 1 
1 1 1 2 1 1 1 1 3 0 0 3 1 1 2 2 1 1 3 0 0 3 1 1 1 1 2 1 1 1 
1 1000 2000 1 0 0 0 1000 1 0 0 1 0 0 4000 4000 0 0 1 0 0 1 1000 0 0 0 1 2000 1000 1 
1 0 0 3 0 0 0 0 1 0 0 3 0 0 3 3 0 0 3 0 0 1 0 0 0 0 3 0 0 1 
2 0 0 0 0 3 3 0 2 0 0 0 0 0 3 3 0 0 0 0 0 2 0 3 3 0 0 0 0 2 
2 0 0 0 0 3 3 0 2 0 0 3 0 0 0 0 0 0 3 0 0 2 0 3 3 0 0 0 0 2 
1 0 0 3 0 0 0 0 1 0 0 1 1 3 2000 2000 3 1 1 0 0 1 0 0 0 0 3 0 0 1 
1 0 0 1 4000 0 0 1000 1 0 0 1 1000 1000 1000 1000 1000 1000 1 0 0 1 1000 0 0 4000 1 0 0 1 
1 0 0 3 1 1 1 1 3 0 0 3 1 1 2 2 1 1 3 0 0 3 1 1 1 1 3 0 0 1 
2 0 0 0 0 0 0 0 0 0 0 0 0 0 0 0 0 0 0 0 0 0 0 0 0 0 0 0 0 2 
2 0 0 0 0 0 0 0 0 0 0 0 0 0 0 0 0 0 0 0 0 0 0 0 0 0 0 0 0 2 
1 0 0 3 1 1 1 1 1 1 1 1 1 1 2 2 1 1 1 1 1 1 1 1 1 1 3 0 0 1 
1 0 0 1 4001 0 0 0 0 0 0 0 1000 1000 1000 1000 1000 1000 0 0 0 0 0 0 0 4001 1 0 0 1 
1 0 0 1 4001 0 0 0 0 0 0 0 0 0 2000 2000 0 0 0 0 0 0 0 0 0 4001 1 0 0 1 
1 0 0 1 0 0 0 0 0 0 0 0 0 0 0 0 0 0 0 0 0 0 0 0 0 0 1 0 0 1 
1 0 0 3 1 3 0 3 1 1 1 1 1 1 2 2 1 1 1 1 1 1 3 0 3 1 3 0 0 1 
2 0 0 0 0 0 0 0 0 0 0 0 0 0 0 0 0 0 0 0 0 0 0 0 0 0 0 0 0 2 
2 0 0 0 0 0 0 0 0 0 0 0 0 0 0 0 0 0 0 0 0 0 0 0 0 0 0 0 0 2 
1 0 0 3 0 3 1 1 3 0 3 1 1 3 0 0 3 1 1 1 3 0 3 1 3 0 3 0 0 1 
1 0 0 1 0 0 1 0 0 0 0 1 1000 0 0 0 0 1000 1 0 0 0 0 1 0 0 1 0 0 1 
1 1000 2000 1 0 1000 1 1000 4001 0 1000 1 1000 0 2000 2000 0 1000 1 1000 0 4001 1000 1 1000 0 1 2000 1000 1 
1 1 1 1 1 1 1 1 1 1 1 1 1 1 2 2 1 1 1 1 1 1 1 1 1 1 1 1 1 1 
