30 30
4,3,3 4,1,4 4,1,4 0,1,4 0,1,4 0,3,4 0,1,3 0,1,3 0,1,3 0,1,3 4,3,3 4,1,3 4,1,3 4,1,3 4,13,3 4,3,3 4,1,3 4,1,3 4,1,3 4,1,3 4,3,3 4,1,3 4,1,3 4,1,3 4,1,3 4,3,3 4,1,3 4,1,3 4,1,3 4,3,4 
4,1,3 4,1000,3 4,2000,3 4,0,3 4,1002,3 4,1,3 4,4001,3 4,0,3 4,1000,3 4,1000,3 4,1,3 4,0,3 4,0,3 4,0,3 4,0,3 4,0,3 4,0,3 4,0,3 4,0,3 4,1,3 4,1000,3 4,1000,3 4,0,3 4,4001,3 4,1,3 4,1002,3 4,0,3 4,2000,3 4,1000,3 4,1,3 
4,12,3 4,0,3 4,0,3 4,0,3 4,0,3 4,13,3 4,0,3 4,0,3 4,0,3 4,0,3 4,12,3 4,0,3 4,1000,3 4,1000,3 4,2000,3 4,2000,3 4,1000,3 4,1000,3 4,0,3 4,12,3 4,0,3 4,0,3 4,0,3 4,0,3 4,13,3 4,0,3 4,0,3 4,0,3 4,0,3 4,12,3 
4,1,3 4,0,3 4,0,3 4,-1,3 4,0,3 4,1,3 4,0,3 4,0,3 4,0,3 4,0,3 4,1,3 4,0,3 4,0,3 4,0,3 4,0,3 4,0,3 4,0,3 4,0,3 4,0,3 4,1,3 4,1002,3 4,0,3 4,0,3 4,0,3 4,1,3 4,0,3 4,0,3 4,0,3 4,0,3 4,1,3 
4,1,3 4,0,3 4,0,3 4,0,3 4,0,3 4,1,3 4,0,3 4,0,3 4,0,3 4,0,3 4,1,3 4,0,3 4,0,3 4,0,3 4,0,3 4,0,3 4,0,3 4,0,3 4,0,3 4,1,3 4,1001,3 4,0,3 4,0,3 4,0,3 4,1,3 4,0,3 4,0,3 4,0,3 4,0,3 4,1,3 
4,3,3 4,1000,3 4,0,3 4,0,3 4,0,3 4,1,3 4,0,3 4,0,3 4,0,3 4,0,3 4,1,3 4,1000,3 4,0,3 4,0,3 4,0,3 4,0,3 4,0,3 4,0,3 4,1000,3 4,1,3 4,0,3 4,0,3 4,0,3 4,0,3 4,1,3 4,0,3 4,0,3 4,0,3 4,1000,3 4,3,3 
4,1,3 4,1,3 4,1,3 4,3,3 4,900,3 4,3,3 4,900,3 4,3,3 4,1,3 4,1,3 4,1,3 4,1,3 4,1,3 4,3,3 4,0,3 4,0,3 4,3,3 4,1,3 4,1,3 4,1,3 4,1,3 4,1,3 4,3,3 4,900,3 4,3,3 4,900,3 4,3,3 4,1,3 4,1,3 4,1,3 
4,1,3 4,2000,3 4,0,3 4,0,3 4,0,3 4,0,3 4,0,3 4,0,3 4,0,3 4,0,3 4,0,3 4,0,3 4,0,3 4,0,3 4,0,3 4,0,3 4,0,3 4,0,3 4,0,3 4,0,3 4,0,3 4,0,3 4,0,3 4,0,3 4,0,3 4,0,3 4,0,3 4,0,3 4,2000,3 4,1,3 
4,1,3 4,1000,3 4,0,3 4,0,3 4,0,3 4,0,3 4,0,3 4,0,3 4,0,3 4,0,3 4,0,3 4,0,3 4,0,3 4,0,3 4,1000,3 4,1000,3 4,0,3 4,0,3 4,0,3 4,0,3 4,0,3 4,0,3 4,0,3 4,0,3 4,0,3 4,0,3 4,0,3 4,0,3 4,1000,3 4,1,3 
4,1,3 4,1,3 4,1,3 4,13,3 4,1,3 4,1,3 4,1,3 4,1,3 4,3,3 4,0,3 4,0,3 4,3,3 4,1,3 4,1,3 4,13,3 4,1,3 4,1,3 4,1,3 4,3,3 4,0,3 4,0,3 4,3,3 4,1,3 4,1,3 4,1,3 4,1,3 0,13,3 4,1,3 4,1,3 4,3,3 
4,3,3 4,0,3 4,2000,3 4,1,3 4,0,3 4,0,3 4,0,3 4,1000,3 4,1,3 4,0,3 4,0,3 4,1,3 4,1002,3 4,0,3 4,4000,3 4,4000,3 4,0,3 4,1002,3 4,1,3 4,0,3 4,0,3 4,1,3 4,1000,3 4,0,3 4,0,3 4,0,3 4,1,3 4,2000,3 4,1000,3 4,1,3 
4,1,3 4,0,3 4,0,3 4,3,3 4,0,3 4,0,3 4,0,3 4,0,3 4,1,3 4,0,3 4,0,3 4,3,3 4,0,3 4,0,3 4,0,3 4,0,3 4,0,3 4,0,3 4,3,3 4,0,3 4,0,3 4,1,3 4,0,3 4,0,3 4,0,3 4,0,3 4,3,3 4,0,3 4,0,3 4,1,3 
4,12,3 4,0,3 4,0,3 4,0,3 4,0,3 4,0,3 4,0,3 4,1002,3 4,13,3 4,0,3 4,0,3 4,900,3 4,0,3 4,0,3 4,0,3 4,0,3 4,0,3 4,0,3 4,900,3 4,0,3 4,0,3 4,12,3 4,1002,3 4,0,3 4,0,3 4,0,3 4,0,3 4,0,3 4,0,3 4,13,3 
4,13,0 4,0,3 4,0,3 4,0,3 4,0,3 4,0,3 4,0,3 4,1001,3 4,12,3 4,0,3 4,0,3 4,3,3 4,0,3 4,0,3 4,0,3 4,0,3 4,0,3 4,0,3 4,3,3 4,0,3 4,0,3 4,13,3 4,1001,3 4,0,3 4,0,3 4,0,3 4,0,3 4,0,3 4,0,3 4,12,3 
4,1,3 4,0,3 4,0,3 4,3,3 4,0,3 4,0,3 4,0,3 4,0,3 4,1,3 4,0,3 4,0,3 4,1,3 4,1,3 4,3,3 4,2000,3 4,2000,3 4,3,3 4,1,3 4,1,3 4,0,3 4,0,3 4,1,3 4,0,3 4,0,3 4,0,3 4,0,3 4,3,3 4,0,3 4,0,3 4,1,3 
4,3,3 4,0,3 4,0,3 4,1,3 4,4000,3 4,0,3 4,0,3 4,1000,3 4,1,3 4,0,3 4,0,3 4,1,3 4,1000,3 4,1000,3 4,1000,3 4,1000,3 4,1000,3 4,1000,3 4,1,3 4,0,3 4,0,3 4,1,3 4,1000,3 4,0,3 4,0,3 4,4000,3 4,1,3 4,0,3 4,0,3 4,3,0 
4,1,3 4,0,3 4,0,3 4,3,3 4,1,3 4,1,3 4,1,3 4,1,3 4,3,3 4,0,3 4,0,3 4,3,3 4,1,3 4,1,3 4,1,3 4,1,3 4,1,3 4,1,3 4,3,3 4,0,3 4,0,3 4,3,3 4,1,3 4,1,3 4,1,3 4,1,3 4,3,3 4,0,3 4,0,3 4,1,3 
4,13,3 4,0,3 4,0,3 4,0,3 4,0,3 4,0,3 4,0,3 4,0,3 4,0,3 4,0,3 4,0,3 4,0,3 4,0,3 4,0,3 4,0,3 4,0,3 4,0,3 4,0,3 4,0,3 4,0,3 4,0,3 4,0,3 4,0,3 4,0,3 4,0,3 4,0,3 4,0,3 4,0,3 4,0,3 0,1,0 
4,12,3 4,0,3 4,0,3 4,0,3 4,0,3 4,0,3 4,0,3 4,0,3 4,0,3 4,0,3 4,0,3 4,0,3 4,0,3 4,0,3 4,0,3 4,0,3 4,0,3 4,0,3 4,0,3 4,0,3 4,0,3 4,0,3 4,0,3 4,0,3 4,0,3 4,0,3 4,0,3 4,0,3 4,0,3 0,13,3 
4,1,3 4,0,3 4,0,3 4,3,0 4,1,0 4,1,0 4,1,0 4,1,3 4,1,3 4,1,3 4,1,3 4,1,3 4,1,3 4,1,3 4,13,3 4,12,3 4,1,3 4,1,3 4,1,3 4,1,3 4,1,3 4,1,3 4,1,3 4,1,3 4,1,3 4,1,3 4,3,3 4,0,3 4,0,3 4,1,3 
4,3,3 4,0,3 4,0,3 4,1,3 4,4001,3 4,0,3 4,0,3 4,0,3 4,0,3 4,0,3 4,0,3 4,0,3 4,1000,3 4,1000,3 4,1000,3 4,1000,3 4,1000,3 4,1000,3 4,0,3 4,0,3 4,0,3 4,0,3 4,0,3 4,0,3 4,0,3 4,4001,3 4,1,3 4,0,3 4,0,3 4,3,3 
4,1,3 4,0,3 4,0,3 4,1,3 4,4001,3 4,0,3 4,0,3 4,0,3 4,0,3 4,0,3 4,0,3 4,0,3 4,0,3 4,0,3 4,2000,3 4,2000,3 4,0,3 4,0,3 4,0,3 4,0,3 4,0,3 4,0,3 4,0,3 4,0,3 4,0,3 4,4001,3 4,1,3 4,0,3 4,0,3 4,1,3 
4,1,0 4,0,3 4,0,3 4,1,3 4,0,3 4,0,3 4,0,3 4,0,3 4,0,3 4,0,3 4,0,3 4,0,3 4,0,3 4,0,3 4,0,3 4,0,3 4,0,3 4,0,3 4,0,3 4,0,3 4,0,3 4,0,3 4,0,3 4,0,3 4,0,3 4,0,3 4,1,3 4,0,3 4,0,3 4,1,3 
4,1,3 4,0,3 4,0,3 4,3,3 4,1,3 4,3,3 4,900,3 4,3,0 4,1,0 4,1,0 4,1,3 4,1,3 4,1,3 4,1,3 4,12,3 4,13,3 4,1,3 4,1,3 4,1,3 4,1,3 4,1,3 4,1,3 4,3,3 4,900,3 4,3,3 4,1,3 4,3,3 4,0,3 4,0,3 4,1,0 
4,12,3 4,0,3 4,0,3 4,0,3 4,0,3 4,0,3 4,0,3 4,0,3 4,0,3 4,0,3 4,0,3 4,0,3 4,0,3 4,0,3 4,0,3 4,0,3 4,0,3 4,0,3 4,0,3 4,0,3 4,0,3 4,0,3 4,0,3 4,0,3 4,0,3 4,0,3 4,0,3 4,0,3 4,0,3 4,1,3 
0,3,3 4,0,3 4,0,3 4,0,3 4,0,3 4,0,3 4,0,3 4,0,3 4,0,3 4,0,3 4,0,3 4,0,3 4,0,3 4,0,3 4,0,3 4,0,3 4,0,3 4,0,3 4,0,3 4,0,3 4,0,3 4,0,3 4,0,3 4,0,3 4,0,3 4,0,3 4,0,3 4,0,3 4,0,3 4,3,3 
4,1,3 4,0,3 4,0,3 4,3,3 4,900,3 4,3,3 4,1,3 4,1,3 4,3,3 4,900,3 4,3,3 4,1,3 4,1,3 4,3,3 4,0,3 4,0,3 4,3,3 4,1,3 4,1,3 4,1,3 4,3,3 4,900,3 4,3,3 4,1,3 4,3,3 4,900,3 4,3,3 4,0,3 4,0,3 4,1,3 
4,1,3 4,0,3 4,0,3 4,1,3 4,0,3 4,0,3 4,1,3 4,0,3 4,0,3 4,0,3 4,0,3 4,1,3 4,1000,3 4,0,3 4,0,3 4,0,3 4,0,3 4,1000,3 4,1,3 4,0,3 4,0,3 4,0,3 4,0,3 4,1,3 4,0,3 4,0,3 4,1,3 4,0,3 4,0,3 4,1,0 
4,1,3 4,1000,3 4,2000,3 4,1,3 4,0,3 4,1000,3 4,1,3 4,1000,3 4,4001,3 4,0,3 4,1000,3 4,1,3 4,1000,3 4,0,3 4,2000,3 4,2000,3 4,0,3 4,1000,3 4,1,3 4,1000,3 4,0,3 4,4001,3 4,1000,3 4,1,3 4,1000,3 4,0,3 4,1,3 4,2000,3 4,1000,3 4,1,0 
4,3,3 4,1,3 4,1,3 4,1,3 4,1,3 4,3,3 4,1,3 4,1,3 4,1,3 4,1,3 4,3,3 4,1,3 4,1,3 4,1,3 4,13,3 4,3,3 4,1,3 4,1,3 4,1,3 4,1,3 4,3,3 4,1,3 4,1,3 4,1,3 4,1,3 4,3,3 4,1,3 4,1,3 4,1,3 4,3,3 
