30 30
0,3,0 0,1,0 0,1,0 0,1,0 0,1,0 0,3,0 0,1,0 0,1,0 0,1,0 0,1,0 0,3,0 0,1,0 0,1,0 0,1,0 0,13,0 0,3,0 0,1,0 0,1,0 0,1,0 0,1,0 0,3,0 0,1,0 0,1,0 0,1,0 0,1,0 0,3,0 0,1,0 0,1,0 0,1,0 0,3,0 
0,1,0 0,1000,0 0,2000,0 0,0,0 0,1002,0 0,1,0 0,4001,0 0,0,0 0,1000,0 0,1000,0 0,1,0 0,0,0 0,0,0 0,0,0 0,0,0 0,0,0 0,0,0 0,0,0 0,0,0 0,1,0 0,1000,0 0,1000,0 0,0,0 0,4001,0 0,1,0 0,1002,0 0,0,0 0,2000,0 0,1000,0 0,1,0 
0,12,0 0,0,0 0,0,0 0,0,0 0,0,0 0,13,0 0,0,0 0,0,0 0,0,0 0,0,0 0,12,0 0,0,0 0,1000,0 0,1000,0 0,2000,0 0,2000,0 0,1000,0 0,1000,0 0,0,0 0,12,0 0,0,0 0,0,0 0,0,0 0,0,0 0,13,0 0,0,0 0,0,0 0,0,0 0,0,0 0,12,0 
0,1,0 0,0,0 0,0,0 0,-1,0 0,0,0 0,1,0 0,0,0 1,0,0 0,0,0 0,0,0 0,1,0 0,0,0 0,0,0 0,0,0 0,0,0 0,0,0 0,0,0 0,0,0 0,0,0 0,1,0 0,1002,0 0,0,0 0,0,0 0,0,0 0,1,0 0,0,0 0,0,0 0,0,0 0,0,0 0,1,0 
0,1,0 0,0,0 0,0,0 0,0,0 0,0,0 0,1,0 0,0,0 0,0,0 0,0,0 0,0,0 0,1,0 0,0,0 0,0,0 0,0,0 0,0,0 0,0,0 0,0,0 0,0,0 0,0,0 0,1,0 0,1001,0 0,0,0 0,0,0 0,0,0 0,1,0 0,0,0 0,0,0 0,0,0 0,0,0 0,1,0 
0,3,0 0,1000,0 0,0,0 0,0,0 0,0,0 0,1,0 0,0,0 0,0,0 0,0,0 0,0,0 0,1,0 0,1000,0 0,0,0 0,0,0 0,0,0 0,0,0 0,0,0 0,0,0 0,1000,0 0,1,0 0,0,0 0,0,0 0,0,0 0,0,0 0,1,0 0,0,0 0,0,0 0,0,0 0,1000,0 0,3,0 
0,1,0 0,1,0 0,1,0 0,3,0 0,900,0 0,3,0 0,900,0 0,3,0 0,1,0 0,1,0 0,1,0 0,1,0 0,1,0 0,3,0 0,0,0 0,0,0 0,3,0 0,1,0 0,1,0 0,1,0 0,1,0 0,1,0 0,3,0 0,900,0 0,3,0 0,900,0 0,3,0 0,1,0 0,1,0 0,1,0 
0,1,0 0,2000,0 0,0,0 0,0,0 0,0,0 0,0,0 0,0,0 0,0,0 0,0,0 0,0,0 0,0,0 0,0,0 0,0,0 0,0,0 0,0,0 0,0,0 0,0,0 0,0,0 0,0,0 0,0,0 0,0,0 0,0,0 0,0,0 0,0,0 0,0,0 0,0,0 0,0,0 0,0,0 0,2000,0 0,1,0 
0,1,0 0,1000,0 0,0,0 0,0,0 0,0,0 0,0,0 0,0,0 0,0,0 0,0,0 0,0,0 0,0,0 0,0,0 0,0,0 0,0,0 0,1000,0 0,1000,0 0,0,0 0,0,0 0,0,0 0,0,0 0,0,0 0,0,0 0,0,0 0,0,0 0,0,0 0,0,0 0,0,0 0,0,0 0,1000,0 0,1,0 
0,1,0 0,1,0 0,1,0 0,13,0 0,1,0 0,1,0 0,1,0 0,1,0 0,3,0 0,0,0 0,0,0 0,3,0 0,1,0 0,1,0 0,13,0 0,1,0 0,1,0 0,1,0 0,3,0 0,0,0 0,0,0 0,3,0 0,1,0 0,1,0 0,1,0 0,1,0 0,13,0 0,1,0 0,1,0 0,3,0 
0,3,0 0,0,0 0,2000,0 0,1,0 0,0,0 0,0,0 0,0,0 0,1000,0 0,1,0 0,0,0 0,0,0 0,1,0 0,1002,0 0,0,0 0,4000,0 0,4000,0 0,0,0 0,1002,0 0,1,0 0,0,0 0,0,0 0,1,0 0,1000,0 0,0,0 0,0,0 0,0,0 0,1,0 0,2000,0 0,1000,0 0,1,0 
0,1,0 0,0,0 0,0,0 0,3,0 0,0,0 0,0,0 0,0,0 0,0,0 0,1,0 0,0,0 0,0,0 0,3,0 0,0,0 0,0,0 0,0,0 0,0,0 0,0,0 0,0,0 0,3,0 0,0,0 0,0,0 0,1,0 0,0,0 0,0,0 0,0,0 0,0,0 0,3,0 0,0,0 0,0,0 0,1,0 
0,12,0 0,0,0 0,0,0 0,0,0 0,0,0 0,0,0 0,0,0 0,1002,0 0,13,0 0,0,0 0,0,0 0,900,0 0,0,0 0,0,0 0,0,0 0,0,0 0,0,0 0,0,0 0,900,0 0,0,0 0,0,0 0,12,0 0,1002,0 0,0,0 0,0,0 0,0,0 0,0,0 0,0,0 0,0,0 0,13,0 
0,13,0 0,0,0 0,0,0 0,0,0 0,0,0 0,0,0 0,0,0 0,1001,0 0,12,0 0,0,0 0,0,0 0,3,0 0,0,0 0,0,0 0,0,0 0,0,0 0,0,0 0,0,0 0,3,0 0,0,0 0,0,0 0,13,0 0,1001,0 0,0,0 0,0,0 0,0,0 0,0,0 0,0,0 0,0,0 0,12,0 
0,1,0 0,0,0 0,0,0 0,3,0 0,0,0 0,0,0 0,0,0 0,0,0 0,1,0 0,0,0 0,0,0 0,1,0 0,1,0 0,3,0 0,2000,0 0,2000,0 0,3,0 0,1,0 0,1,0 0,0,0 0,0,0 0,1,0 0,0,0 0,0,0 0,0,0 0,0,0 0,3,0 0,0,0 0,0,0 0,1,0 
0,3,0 0,0,0 0,0,0 0,1,0 0,4000,0 0,0,0 0,0,0 0,1000,0 0,1,0 0,0,0 0,0,0 0,1,0 0,1000,0 0,1000,0 0,1000,0 0,1000,0 0,1000,0 0,1000,0 0,1,0 0,0,0 0,0,0 0,1,0 0,1000,0 0,0,0 0,0,0 0,4000,0 0,1,0 0,0,0 0,0,0 0,3,0 
0,1,0 0,0,0 0,0,0 0,3,0 0,1,0 0,1,0 0,1,0 0,1,0 0,3,0 0,0,0 0,0,0 0,3,0 0,1,0 0,1,0 0,1,0 0,1,0 0,1,0 0,1,0 0,3,0 0,0,0 0,0,0 0,3,0 0,1,0 0,1,0 0,1,0 0,1,0 0,3,0 0,0,0 0,0,0 0,1,0 
0,13,0 0,0,0 0,0,0 0,0,0 0,0,0 0,0,0 0,0,0 0,0,0 0,0,0 0,0,0 0,0,0 0,0,0 0,0,0 0,0,0 0,0,0 0,0,0 0,0,0 0,0,0 0,0,0 0,0,0 0,0,0 0,0,0 0,0,0 0,0,0 0,0,0 0,0,0 0,0,0 0,0,0 0,0,0 0,1,0 
0,12,0 0,0,0 0,0,0 0,0,0 0,0,0 0,0,0 0,0,0 0,0,0 0,0,0 0,0,0 0,0,0 0,0,0 0,0,0 0,0,0 0,0,0 0,0,0 0,0,0 0,0,0 0,0,0 0,0,0 0,0,0 0,0,0 0,0,0 0,0,0 0,0,0 0,0,0 0,0,0 0,0,0 0,0,0 0,13,0 
0,1,0 0,0,0 0,0,0 0,3,0 0,1,0 0,1,0 0,1,0 0,1,0 0,1,0 0,1,0 0,1,0 0,1,0 0,1,0 0,1,0 0,13,0 0,12,0 0,1,0 0,1,0 0,1,0 0,1,0 0,1,0 0,1,0 0,1,0 0,1,0 0,1,0 0,1,0 0,3,0 0,0,0 0,0,0 0,1,0 
0,3,0 0,0,0 0,0,0 0,1,0 0,4001,0 0,0,0 0,0,0 0,0,0 0,0,0 0,0,0 0,0,0 0,0,0 0,1000,0 0,1000,0 0,1000,0 0,1000,0 0,1000,0 0,1000,0 0,0,0 0,0,0 0,0,0 0,0,0 0,0,0 0,0,0 0,0,0 0,4001,0 0,1,0 0,0,0 0,0,0 0,3,0 
0,1,0 0,0,0 0,0,0 0,1,0 0,4001,0 0,0,0 0,0,0 0,0,0 0,0,0 0,0,0 0,0,0 0,0,0 0,0,0 0,0,0 0,2000,0 0,2000,0 0,0,0 0,0,0 0,0,0 0,0,0 0,0,0 0,0,0 0,0,0 0,0,0 0,0,0 0,4001,0 0,1,0 0,0,0 0,0,0 0,1,0 
0,1,0 0,0,0 0,0,0 0,1,0 0,0,0 0,0,0 0,0,0 0,0,0 0,0,0 0,0,0 0,0,0 0,0,0 0,0,0 0,0,0 0,0,0 0,0,0 0,0,0 0,0,0 0,0,0 0,0,0 0,0,0 0,0,0 0,0,0 0,0,0 0,0,0 0,0,0 0,1,0 0,0,0 0,0,0 0,1,0 
0,1,0 0,0,0 0,0,0 0,3,0 0,1,0 0,3,0 0,900,0 0,3,0 0,1,0 0,1,0 0,1,0 0,1,0 0,1,0 0,1,0 0,12,0 0,13,0 0,1,0 0,1,0 0,1,0 0,1,0 0,1,0 0,1,0 0,3,0 0,900,0 0,3,0 0,1,0 0,3,0 0,0,0 0,0,0 0,1,0 
0,12,0 0,0,0 0,0,0 0,0,0 0,0,0 0,0,0 0,0,0 0,0,0 0,0,0 0,0,0 0,0,0 0,0,0 0,0,0 0,0,0 0,0,0 0,0,0 0,0,0 0,0,0 0,0,0 0,0,0 0,0,0 0,0,0 0,0,0 0,0,0 0,0,0 0,0,0 0,0,0 0,0,0 0,0,0 0,1,0 
0,3,0 0,0,0 0,0,0 0,0,0 0,0,0 0,0,0 0,0,0 0,0,0 0,0,0 0,0,0 0,0,0 0,0,0 0,0,0 0,0,0 0,0,0 0,0,0 0,0,0 0,0,0 0,0,0 0,0,0 0,0,0 0,0,0 0,0,0 0,0,0 0,0,0 0,0,0 0,0,0 0,0,0 0,0,0 0,3,0 
0,1,0 0,0,0 0,0,0 0,3,0 0,900,0 0,3,0 0,1,0 0,1,0 0,3,0 0,900,0 0,3,0 0,1,0 0,1,0 0,3,0 0,0,0 0,0,0 0,3,0 0,1,0 0,1,0 0,1,0 0,3,0 0,900,0 0,3,0 0,1,0 0,3,0 0,900,0 0,3,0 0,0,0 0,0,0 0,1,0 
0,1,0 0,0,0 0,0,0 0,1,0 0,0,0 0,0,0 0,1,0 0,0,0 0,0,0 0,0,0 0,0,0 0,1,0 0,1000,0 0,0,0 0,0,0 0,0,0 0,0,0 0,1000,0 0,1,0 0,0,0 0,0,0 0,0,0 0,0,0 0,1,0 0,0,0 0,0,0 0,1,0 0,0,0 0,0,0 0,1,0 
0,1,0 0,1000,0 0,2000,0 0,1,0 0,0,0 0,1000,0 0,1,0 0,1000,0 0,4001,0 0,0,0 0,1000,0 0,1,0 0,1000,0 0,0,0 0,2000,0 0,2000,0 0,0,0 0,1000,0 0,1,0 0,1000,0 0,0,0 0,4001,0 0,1000,0 0,1,0 0,1000,0 0,0,0 0,1,0 0,2000,0 0,1000,0 0,1,0 
0,3,0 0,1,0 0,1,0 0,1,0 0,1,0 0,3,0 0,1,0 0,1,0 0,1,0 0,1,0 0,3,0 0,1,0 0,1,0 0,1,0 0,13,0 0,3,0 0,1,0 0,1,0 0,1,0 0,1,0 0,3,0 0,1,0 0,1,0 0,1,0 0,1,0 0,3,0 0,1,0 0,1,0 0,1,0 0,3,0 