30 30
9 1 2 2 1 9 1 2 2 1 9 1 1 1 2 9 1 1 1 1 9 2 2 1 1 9 2 2 1 9 
1 2000 0 0 0 1 0 0 0 0 1 0 0 0 0 0 0 0 0 1 0 0 0 0 1 0 0 0 0 1 
2 0 0 0 0 2 0 0 0 0 2 0 0 0 0 0 0 0 0 2 0 0 0 0 2 0 0 0 0 2 
2 0 0 -1 0 2 0 0 0 0 2 0 0 0 0 0 0 0 0 2 0 0 0 0 2 0 0 0 0 2 
1 0 0 0 0 1 0 0 0 0 1 0 0 0 0 0 0 0 0 1 0 0 0 0 1 0 0 0 0 1 
9 0 0 0 0 1 0 0 0 0 1 0 0 0 0 0 0 0 0 1 0 0 0 0 1 0 0 0 0 9 
1 1 1 3 900 3 900 3 1 1 1 1 1 3 0 0 3 1 1 1 1 1 3 900 3 900 3 1 1 1 
1 0 0 0 0 0 0 0 0 0 0 0 0 0 0 0 0 0 0 0 0 0 0 0 0 0 0 0 0 1 
1 0 0 0 0 0 0 0 0 0 0 0 0 0 0 0 0 0 0 0 0 0 0 0 0 0 0 0 0 1 
1 1 1 2 1 1 1 1 3 0 0 3 1 1 2 2 1 1 3 0 0 3 1 1 1 1 2 1 1 9 
9 0 0 1 0 0 0 0 1 0 0 1 0 0 0 0 0 0 1 0 0 1 0 0 0 0 1 0 0 1 
1 0 0 3 0 0 0 0 1 0 0 3 0 0 0 0 0 0 3 0 0 1 0 0 0 0 3 0 0 1 
2 0 0 0 0 0 0 0 2 0 0 900 0 0 0 0 0 0 900 0 0 2 0 0 0 0 0 0 0 2 
2 0 0 0 0 0 0 0 2 0 0 3 0 0 0 0 0 0 3 0 0 2 0 0 0 0 0 0 0 2 
1 0 0 3 0 0 0 0 1 0 0 1 1 3 0 0 3 1 1 0 0 1 0 0 0 0 3 0 0 1 
9 0 0 1 0 0 0 0 1 0 0 1 0 0 0 0 0 0 1 0 0 1 0 0 0 0 1 0 0 9 
1 0 0 3 1 1 1 1 3 0 0 3 1 1 2 2 1 1 3 0 0 3 1 1 1 1 3 0 0 1 
2 0 0 0 0 0 0 0 0 0 0 0 0 0 0 0 0 0 0 0 0 0 0 0 0 0 0 0 0 2 
2 0 0 0 0 0 0 0 0 0 0 0 0 0 0 0 0 0 0 0 0 0 0 0 0 0 0 0 0 2 
1 0 0 3 1 1 1 1 1 1 1 1 1 1 2 2 1 1 1 1 1 1 1 1 1 1 3 0 0 1 
9 0 0 1 0 0 0 0 0 0 0 0 0 0 0 0 0 0 0 0 0 0 0 0 0 0 1 0 0 9 
1 0 0 1 0 0 0 0 0 0 0 0 0 0 0 0 0 0 0 0 0 0 0 0 0 0 1 0 0 1 
1 0 0 1 0 0 0 0 0 0 0 0 0 0 0 0 0 0 0 0 0 0 0 0 0 0 1 0 0 1 
1 0 0 3 1 3 900 3 1 1 1 1 1 1 2 2 1 1 1 1 1 1 3 900 3 1 3 0 0 1 
2 0 0 0 0 0 0 0 0 0 0 0 0 0 0 0 0 0 0 0 0 0 0 0 0 0 0 0 0 2 
9 0 0 0 0 0 0 0 0 0 0 0 0 0 0 0 0 0 0 0 0 0 0 0 0 0 0 0 0 9 
1 0 0 3 900 3 1 1 3 900 3 1 1 3 0 0 3 1 1 1 3 900 3 1 3 900 3 0 0 1 
1 0 0 1 0 0 1 0 0 0 0 1 0 0 0 0 0 0 1 0 0 0 0 1 0 0 1 0 0 1 
1 0 0 1 0 0 1 0 0 0 0 1 0 0 0 0 0 0 1 0 0 0 0 1 0 0 1 0 0 1 
9 1 1 1 1 9 1 1 1 1 9 1 1 1 2 9 1 1 1 1 9 1 1 1 1 9 1 1 1 9 
